%%%%%%%%%%%%%%%%%%%%%%%%%%%%%%%%%%%%%%%%%%%%%%%%%%%%%%%%%%
%                                                        %
%                                           G            %
%                                                        %
%                                                        %
%                                                        %
%                                                        %
%                                                        %
%                                                        %
%                                                        %
%                                                        %
%            P                                           %
%                                                        %
%                                                        %
%                                                        %
%                                                        %
%                                                        %
%              G                                         %
%                                                        %
%                                                        %
%                                                        %
%                                                        %
%                                                        %
%                                                        %
%                                                        %
%                                                        %
%%%%%%%%%%%%%%%%%%%%%%%%%%%%%%%%%%%%%%%%%%%%%%%%%%%%%%%%%%
